4,4,3,2,7,7,2,3,4,3,2,7,7,2,3,4,4
4,4,3,2,7,7,2,3,4,3,2,7,7,2,3,4,4
4,4,3,2,7,7,2,3,4,3,2,7,7,2,3,4,4
4,4,3,2,7,7,2,3,4,3,2,7,7,2,3,4,4
4,4,3,2,7,7,2,3,4,3,2,7,7,2,3,4,4
9,9,9,9,9,9,9,9,9,9,9,9,9,9,9,7,7
9,9,9,9,9,9,9,9,9,9,9,9,9,9,9,9,9
4,4,3,2,6,6,2,3,4,3,2,6,6,2,3,4,4
4,4,3,2,6,6,2,3,4,3,2,6,6,2,3,4,4
4,4,3,2,6,6,2,3,4,3,2,6,6,2,3,4,4
4,4,3,2,6,6,2,3,4,3,2,6,6,2,3,4,4
4,4,3,2,6,6,2,3,4,3,2,6,6,2,3,4,4
